000000000000000000000000000000000
011111111111111111111111111111110
011111111111111111111111111111110
011111111111111111111111111111110
011111111111111111111111111111110
011111111111111111111111111111110
011111111111111111111111111111110
011111100000000000000000001111110
011111111111111111111111111111110
011111111111111111111111111111110
011111100000000000000000001111110
011111111111111111111111111111110
011101101111111111111111101101110
011101101111111111111111101101110
011101101111111111111111101101110
011101101111111111111111101101110
011101101111111111111111101101110
011101101111111111111111101101110
011101101111111111111111101101110
011101101111111111111111101101110
011101101111111111111111101101110
011101101111111111111111101101110
011101101111111111111111101101110
011101101111111111111111101101110
011101101111111111111111101101110
011101101111111111111111101101110
011101101111111111111111101101110
011101101111111111111111101101110
011101101111111111111111101101110
011101101111111111111111101101110
011101101111111111111111101101110
011101101111111111111111101101110
000000000000000000000000000000000
