000000000000000000000000000000000
011111111111111111111111111111110
011111111111111111111111111111110
011111111111111111111111111111110
011111111111111111111111111111110
011111111111111111111111111111110
011100000000001111100000000001110
011101111111111111111111111101110
011101111111111111111111111101110
011101100000001111100000001101110
011101101111111111111111101101110
011101101111111111111111101101110
011101101111111111111111101101110
011101101111111111111111101101110
011101101111111111111111101101110
011101101111111111111111101101110
011101101111111111111111101101110
011101101111111111111111101101110
011101101111111111111111101101110
011101101111111111111111101101110
011101101111111111111111101101110
011101101111111111111111101101110
011101100000001111100000001101110
011101111111111111111111111101110
011101111111111111111111111101110
011100000000001111100000000001110
011111111111111111111111111111110
011111111111111111111111111111110
011111111111111111111111111111110
011111111111111111111111111111110
011111111111111111111111111111110
011111111111111111111111111111110
000000000000000000000000000000000
