000000000000000000000000000000000
011111110011110011001111111111110
011100110010010011001111100111110
011100110010011111001100100111110
000100111111111111111100111110010
000111110011100100111111001110010
011111110011100100100111001111110
010011111111111100100111111110010
010011110010011111111110010010010
011110010010011110011110010010010
011110010010010010010011111111110
000011110010010010010011111111110
000011110011110010011111100001000
011111111110010011000111100001000
011111111110011111000111111111110
011110000010010011111111111111110
011110000011110011110010011001000
000011111110011111110010011001000
000010001110010010011111111001110
011110001001110010010011100111110
011111111001111111110011100111000
011100011111110011111111100111000
011100010010010011111111111111110
001111110010010010001100011100110
001000110011111110001100011100110
001000111111100011111111111111110
001111110011100010011111100100110
001100010011111110011011100100100
001100010010011111111010011111100
011111111110010111111010011001100
011000111111110110011111111001110
011000111111110110011111111111110
000000000000000000000000000000000
