000000000000000000000000000000000
011111111111111111111111111111110
011111111111111111111111111111110
011000000000000000000000000000110
011111111111111111111111111111110
011111111111111111111111111111110
011000000000111111111000000000110
011111111110111111111011111111110
011111111110111111111011111111110
011000000110111111111011000000110
011111110110111111111011011111110
011111110110111111111011011111110
011000110110111111111011011000110
011110110110111111111011011011110
011110110110111111111011011011110
011110110110111111111011011011110
011110110110111111111011011011110
011110110110111111111011011011110
011110110110111111111011011011110
011110110110111111111011011011110
011110110110111111111011011011110
011110110110111111111011011011110
011110110110111111111011011011110
011110110110111111111011011011110
011110110110111111111011011011110
011110110110111111111011011011110
011110110110111111111011011011110
011110110110111111111011011011110
011110110110111111111011011011110
011110110110111111111011011011110
011111111111111111111111111111110
011111111111111111111111111111110
000000000000000000000000000000000
