000000000000000000000000000000000
011111111111111111111111111111110
011111111111111111111111111111110
011111111111111111111111111111110
011111111111111111111111111111110
011101101111000000000000000001110
011101101111111111111111111101110
011101101111111111111111111101110
011101101111000000000000001101110
011101101111111111111111101101110
011101101111111111111111101101110
011101101111111111111111101101110
011101101111111111111111101101110
011101101111111111111111101101110
011101101111111111111111101101110
011101101111111111111111101101110
011101101111111111111111101101110
011101101111111111111111101101110
011101101111111111111111101101110
011101101111111111111111101101110
011101101111111111111111101101110
011101101111111111111111101101110
011101101111111111111111101101110
011101101111111111111111101101110
011101101111111111111111101101110
011101100000000000000111101101110
011101111111111111111111101101110
011101111111111111111111101101110
011100000000000000000111101101110
011111111111111111111111111111110
011111111111111111111111111111110
011111111111111111111111111111110
000000000000000000000000000000000
