000000000000000000000000000000000
011111111111111111111111111111110
011111111111111111111111111111110
011100000000000000000000000011110
011111111111111111111111111111110
011111111111111111111111111111110
011111111111111111111111111111110
011100000000001111000000000011110
011111111111101111011111111111110
011111111111101111011111111111110
011111111111101111011111111111110
011100000011101111011100000011110
011111111011101111011101111111110
011111111011101111011101111111110
011111111011101111011101111111110
011111111011101111011101111111110
011111111011101111011101111111110
011111111011101111011101111111110
011111111011101111011101111111110
011111111011101111011101111111110
011111111011101111011101111111110
011111111011101111011101111111110
011111111011101111011101111111110
011111111011101111011101111111110
011111111011101111011101111111110
011111111011101111011101111111110
011111111011101111011101111111110
011111111011101111011101111111110
011111111111111111111111111111110
011111111111111111111111111111110
011111111111111111111111111111110
011111111111111111111111111111110
000000000000000000000000000000000
