000000000000000000000000000000000
011111111111111111111111111111110
011111111111111111111111111111110
011111111111111111111111111111110
011111000000000000000000000111110
011111111111111111111111111111110
011101111111111111111111111101110
011101111111111111111111111101110
011101111100000000000001111101110
011101111111111111111111111101110
011101110111111111111111011101110
011101110111111111111111011101110
011101110111110000011111011101110
011101110111111111111111011101110
011101110111011111110111011101110
011101110111011010110111011101110
011101110111011111110111011101110
011101110111011010110111011101110
011101110111011111110111011101110
011101110111111111111111011101110
011101110111110000011111011101110
011101110111111111111111011101110
011101110111111111111111011101110
011101111111111111111111111101110
011101111100000000000001111101110
011101111111111111111111111101110
011101111111111111111111111101110
011111111111111111111111111111110
011111000000000000000000000111110
011111111111111111111111111111110
011111111111111111111111111111110
011111111111111111111111111111110
000000000000000000000000000000000
