
000000000000000000000000000000000
011111111111111111111111111111110
011111111111111111111111111111110
011111111111111111111111111111110
011111111111111111111111111111110
011111000000000000000000000011110
011111111111111111111111111111110
011111111111111111111111111111110
011111111111111111111111111111110
011111000000000111100000000011110
011111111111110111101111111111110
011111111111110111101111111111110
011111111111110111101111111111110
011111111111110111101111111111110
011111111111110111101111111111110
011111111111110111101111111111110
011111111111110111101111111111110
011111111111110111101111111111110
011111111111110111101111111111110
011111111111110111101111111111110
011111111111110111101111111111110
011111111111110111101111111111110
011111111111110111101111111111110
011111111111110111101111111111110
011111111111110111101111111111110
011111111111110111101111111111110
011111111111110111101111111111110
011111111111111111111111111111110
011111111111111111111111111111110
011111111111111111111111111111110
011111111111111111111111111111110
011111111111111111111111111111110
000000000000000000000000000000000
