000000000000000000000000000000000
011111111111111111111111111111110
011111111111111111111111111111110
011111111111111111111111111111110
011111111111111111111111111111110
011111111111111111111111111111110
011111111111111111111111111111110
011111100000000000000001101111110
011111101111111111111101101111110
011111101111111111111101101111110
011111101100000001111101101111110
011111101101111101111101101111110
011111101101010101111101101111110
011111101101111101111101101111110
011111101101111101111101101111110
011111101101111101111101101111110
011111101101111101111101101111110
011111101101111101111101101111110
011111101101111101111101101111110
011111101101111101111101101111110
011111101101111101010101101111110
011111101101111101111101101111110
011111101101111100000001101111110
011111101101111111111111101111110
011111101101111111111111101111110
011111101100000000000000001111110
011111111111111111111111111111110
011111111111111111111111111111110
011111111111111111111111111111110
011111111111111111111111111111110
011111111111111111111111111111110
011111111111111111111111111111110
000000000000000000000000000000000
