000000000000000000000000000000000
011111111111111111111111111111110
011111111111111111111111111111110
011111111111111111111111111111110
011100000000000000000000000001110
011111111111111111111111111111110
011110000000000000000000000011110
011111111111111111111111111111110
011100000000000000000000000001110
011111111111111111111111111111110
011111111111111101111111111111110
011111111111111111111111111111110
011101110111010000010111011101110
011101110111011111110111011101110
010101010101011101110101010101010
010101010101011111110101010101010
010101010101010000010101010101010
010101010101011111110101010101010
010101010101011101110101010101010
010101010101011111110101010101010
010101010101010000010101010101010
011101110111011111110111011101110
010101010101011101110101010101010
010101010101011111110101010101010
010101010101010000010101010101010
010101010101011111110101010101010
010101010101011111110101010101010
010101010101011111110101010101010
010101010101011111110101010101010
011101110111011111110111011101110
011101110111011111110111011101110
011101110111011111110111011101110
000000000000000000000000000000000
