000000000000000000000000000000000
011111111111111111111111111111110
011111111111111111111111111111110
011111111111111111111111111111110
011100000000000000000000000001110
011111111111111111111111111111110
011111111111111111111111111111110
011111111111111111111111111111110
000000000000000111000000000000000
011111111111110111011111111111110
011111111111110111011111111111110
011100000000110111011000000001110
011111111110110111011011111111110
011111111110110111011011111111110
011000001110110111011011000000110
011111101110110111011011011111110
011111101110110111011011011111110
011111101110110111011011011111110
011111101110110111011011011111110
011111101110110111011011011111110
011111101110110111011011011111110
011111101110110111011011011111110
011111101110110111011011011111110
011111101110110111011011011111110
011111101110110111011011011111110
011111101110110111011011011111110
011111101110110111011011011111110
011111101110110111011011011111110
011111101110110111011011011111110
011111101111110111011111011111110
011111101111111111111111011111110
011111101111111111111111011111110
000000000000000000000000000000000
