000000000000000000000000000000000
011111111111111111111111111111110
011111111111111111111111111111110
010000000000000000000000000000010
011111111111111111111111111111110
011111111111111111111111111111110
010000000000000000000000000000010
011111111111111111111111111111110
011111111111111111111111111111110
011111111111111111111111111111110
010101010110000000000011010101010
010101010111111111111111010101010
010101010111111111111111010101010
010101010110000000000011010101010
010101010111111111111111010101010
010101010111111111111111010101010
010101010110000000000011010101010
010101010111111111111111010101010
010101010111111111111111010101010
010101010110000000000011010101010
010101010111111111111111010101010
010101010111111111111111010101010
010101010111111111111111010101010
010101010111111111111111010101010
010101010111111111111111010101010
010101010111111111111111010101010
010101010111111111111111010101010
010101010111111111111111010101010
010101010111111111111111010101010
011101110111111111111111011101110
010101010111111111111111010101010
011101110111111111111111011101110
000000000000000000000000000000000
