000000000000000000000000000000000
011111111111111111111111111111110
011111111111111111111111111111110
011111111111111111111111111111110
011111111111111111111111111111110
011111111111111111111111111111110
011111111111111111111111111111110
011111110111111111111111011111110
011111110111111111111111011111110
011111110111111111111111011111110
011111110111111111111111011111110
011111110111111111111111011111110
011111110111111111111111011111110
011111110111111111111111011111110
011111110111111111111111011111110
011111110111111111111111011111110
011111110111111111111111011111110
011111110111111111111111011111110
011111110111111111111111011111110
011111110111111111111111011111110
011111110111111111111111011111110
011111110111111111111111011111110
011111110111111111111111011111110
011111110111111111111111011111110
011111110111111111111111011111110
011111110111111111111111011111110
011111111111111111111111111111110
011111111111111111111111111111110
011111111111111111111111111111110
011111111111111111111111111111110
011111111111111111111111111111110
011111111111111111111111111111110
000000000000000000000000000000000
