000000000000000000000000000000000
011111111111111111111111111111110
011111111111111111111111111111110
011011011011011111110110110110110
011011011011011111110110110110110
011011011011011111110110110110110
011011011011011111110110110110110
011011011011011111110110110110110
011011011011011111110110110110110
011011011011011111110110110110110
011011011011011111110110110110110
011011011011011111110110110110110
011011011011011111110110110110110
011011011011011111110110110110110
011011011011011111110110110110110
011011011011011111110110110110110
011011011011011111110110110110110
011011011011011111110110110110110
011011011011011111110110110110110
011011011011011111110110110110110
011011011011011111110110110110110
011011011011011111110110110110110
011011011011011111110110110110110
011011011011011111110110110110110
011011011011011111110110110110110
011011011011011111110110110110110
011011011011011111110110110110110
011011011011011111110110110110110
011011011011011111110110110110110
011111111111111111111111111111110
011111111111111111111111111111110
011111111111111111111111111111110
000000000000000000000000000000000
