000000000000000000000000000000000
011111111111111111111111111111110
010111111111111000111111111111010
011111111111111111111111111111110
011100000000000010000000000001110
011101111111111010111111111101110
011101011111001111100111110101110
011101111111111010111111111101110
011101111111111010111111111101110
011101111111111010111111111101110
011101111111111010111111111101110
011101111111111010111111111101110
011101011111001111100111110101110
011101011111011010110111110101110
011101111111110010011111111101110
010100100000100111001000001001010
010111111111111101111111111111010
010100100000100111001000001001010
011101111111110010011111111101110
011101011111011010110111110101110
011101011111001111100111110101110
011101111111111010111111111101110
011101111111111010111111111101110
011101111111111010111111111101110
011101111111111010111111111101110
011101111111111010111111111101110
011101011111001111100111110101110
011101111111111010111111111101110
011100000000000010000000000001110
011111111111111111111111111111110
010111111111111000111111111111010
011111111111111111111111111111110
000000000000000000000000000000000
