000000000000000000000000000000000
011111111111111011011111111111110
010111111111111011011111111111010
011111111111111011011111111111110
011111111111111111111111111101110
011111111111111011011111111111110
011111111111111011011111110111110
011111111111111011011111011111110
011111111111111011011111111111110
011111111111111011011101111111110
011111111111110011011111111111110
011111111111100111010111111111110
011111111111001111011111111111110
011111111110011111000000000001000
011111111100111001111111111111110
011111111001111001111111111111110
000100000011110000001111000001000
011111111111111110011110011111110
011111111111111110011100111111110
000100000000000011111001111111110
011111111111111011110011111111110
011111111111101011100111111111110
011111111111111011001111111111110
011111111110111011011111111111110
011111111111111011011111111111110
011111111011111011011111111111110
011111011111111011011111111111110
011111111111111011011111111111110
011101111111111011111111111111110
011111111111111011011111111111110
010111111111111011011111111111010
011111111111111011011111111111110
000000000000000000000000000000000
