000000000000000000000000000000000
011111111111111111111111111111110
011111111111111111111111111111110
011111111111111111111111111111110
011111111111111111111111111111110
011110110111111111111111011011110
011110110111111111111111011011110
011110110111111111111111011011110
011110110111111111111111011011110
011110110111111111111111011011110
011110110111111111111111011011110
011110110111111111111111011011110
011110110111111111111111011011110
011110110111111111111111011011110
011110110111111111111111011011110
011110110111111111111111011011110
011110110111111111111111011011110
011110110111111111111111011011110
011110110111111111111111011011110
011110110111111111111111011011110
011110110111111111111111011011110
011110110111111111111111011011110
011110110111111111111111011011110
011110110111111111111111011011110
011110110111111111111111011011110
011110110111111111111111011011110
011110110111111111111111011011110
011110110111111111111111011011110
011111111111111111111111111111110
011111111111111111111111111111110
011111111111111111111111111111110
011111111111111111111111111111110
000000000000000000000000000000000
