000000000000000000000000000000000
011111111111111111111111111111110
011111011111111111111111111111110
011011011100000000000000000000110
011011011111111111111111111110110
011011011111111111111111111110110
011011011100000000000000000110110
011011011111111111111111110110110
011011011111111111111111110110110
011011011111111111111111110110110
011011011111111111111111110110110
011011011111111111111111110110110
011011011110000000010111110110110
011011011111111111110111110110110
011011011110100110010111110110110
011011011110102222010111110110110
011011011110102222010111110110110
011011011110102222010111110110110
011011011110100110010111110110110
011011011110111111111111110110110
011011011110100000000111110110110
011011011111111111111111110110110
011011011111111111111111110110110
011011011111111111111111110110110
011011011111111111111111110110110
011011011111111111111111110110110
011011000000000000000000110110110
011011111111111111111111110110110
011011111111111111111111110110110
011000000000000000000000110110110
011111111111111111111111110111110
011111111111111111111111111111110
000000000000000000000000000000000
