000000000000000000000000000000000
011111111111111111111111111111110
011111111111111111111111111111110
011000000000011111110000000000110
011011111111111111111111111110110
011011111111111111111111111110110
011011000000000000000000000110110
011011011111111111111111110110110
011011011111111111111111110110110
011011011000001111100000110110110
011011011011111111111110110110110
011011011011111101111110110110110
011011111011111101111110111110110
011011111011111101111110111110110
011011111011111101111110111110110
011011111011111111111110111110110
011011111010000111000010111110110
011011111011111111111110111110110
011011111011111101111110111110110
011011111011111101111110111110110
011011111011111101111110111110110
011011111011111101111110110110110
011011011011111111111110110110110
011011011000001111100000110110110
011011011111111111111111110110110
011011011111111111111111110110110
011011000000000000000000000110110
011011111111111111111111111110110
011011111111111111111111111110110
011000000000111111111000000000110
011111111111111111111111111111110
011111111111111111111111111111110
000000000000000000000000000000000
