000000000000000000000000000000000
011111111111111111111111111111110
011111111111111111111111111111110
011111111111111111111111111111110
011100000000001111110000000001110
011101111111111111111111111101110
011101111111111111111111111101110
011101111111111111111111111101110
011101110000001111110000011101110
011101110111111111111111011101110
011101110111111111111111011101110
011101110110000000000011011101110
011101110110111111111011011101110
011101110110111111111011011101110
011101110110111111111011011101110
011101110111111111111111011101110
011101110111111111111111011101110
011101110111111111111111011101110
011101110110111111111011011101110
011101110110111111111011011101110
011101110110111111111011011101110
011101110110000000000011011101110
011101110111111111111111011101110
011101110111111111111111011101110
011101110000001111110000011101110
011101111111111111111111111101110
011101111111111111111111111101110
011101111111111111111111111101110
011100000000001111110000000001110
011111111111111111111111111111110
011111111111111111111111111111110
011111111111111111111111111111110
000000000000000000000000000000000
