000000000000000000000000000000000
011111111111111111111111111111110
011111111111111111111111111111110
011111111111111111111111111111110
011111111111111111111111111111110
011111111111111111111111111111110
011111101111000000000000001111110
011111101111111111111111101111110
011111101111111111111111101111110
011111101111111111111111101111110
011111101111111111111111101111110
011111101111111111111111101111110
011111101111111111111111101111110
011111101111111111111111101111110
011111101111111111111111101111110
011111101111111111111111101111110
011111101111111101111111101111110
011111101111111111111111101111110
011111101111111111111111101111110
011111101111111111111111101111110
011111101111111111111111101111110
011111101111111111111111101111110
011111101111111111111111101111110
011111101111111111111111101111110
011111101111111111111111101111110
011111101111111111111111101111110
011111100000000000000111101111110
011111111111111111111111111111110
011111111111111111111111111111110
011111111111111111111111111111110
011111111111111111111111111111110
011111111111111111111111111111110
000000000000000000000000000000000
