000000000000000000000000000000000
011111111111111111111111111111110
011111101111111111111111111111110
011111101111111111111111111111110
011101101000000000000000000001110
011101101111111111111111111101110
011101101111111111111111111101110
011101101110000000000000001101110
011101101111111111111111101101110
011101101111111000111111101101110
011101101111111111111111101101110
011101101111111000111111101101110
011101101111111111111111101101110
011101101111111010111111101101110
011101101111111010111111101101110
011101101010100111001010101101110
011101101010111101111010101101110
011101101010100111001010101101110
011101101111111010111111101101110
011101101111111010111111101101110
011101101111111111111111101101110
011101101111111000111111101101110
011101101111111111111111101101110
011101101111111000111111101101110
011101101111111111111111101101110
011101100000000000000011101101110
011101111111111111111111101101110
011101111111111111111111101101110
011100000000000000000000101101110
011111111111111111111111101111110
011111111111111111111111101111110
011111111111111111111111111111110
000000000000000000000000000000000
