000000000000000000000000000000000
011111111111111111111111111111110
011111111111111111111111111111110
011110000000000000000000000011110
011111111111111111111111111111110
011111111111111111111111111111110
011111111111111111111111111111110
011110000000000000000000000011110
011111111111111111111111111111110
011111111111111111111111111111110
011111111111111111111111111111110
011110111011111111111110111011110
011110111011111111111110111011110
011110111011111111111110111011110
011110101011111111111110101011110
011110101011111111111110101011110
011110101011111111111110101011110
011110101011111111111110101011110
011110101011111111111110101011110
011110101011111111111110101011110
011110101011111111111110101011110
011110101011111111111110101011110
011110101011111111111110101011110
011110101011111111111110101011110
011110101011111111111110101011110
011110101011111111111110101011110
011110101011111111111110101011110
011110101011111111111110101011110
011110101011111111111110101011110
011110111011111111111110111011110
011110101011111111111110101011110
011110111011111111111110111011110
000000000000000000000000000000000
