000000000000000000000000000000000
011111111111111111111111111111110
011111111111111111111111111111110
011011111111111111111111111110110
011110000000000010000000000011110
011100111111111010111111111001110
011101111110011111110011111101110
011101111111111010111111111101110
011101111111111010111111111101110
011101111111111010111111111101110
011101111111111010111111111101110
011101011110011111110011110101110
011101011110011111110011110101110
011101111111111010111111111101110
011101111111110010011111111101110
011100100001100111001100001001110
011111111111111111111111111111110
011100100001100111001100001001110
011101111111110010011111111101110
011101111111111010111111111101110
011101011110011111110011110101110
011101011110011111110011110101110
011101111111111010111111111101110
011101111111111010111111111101110
011101111111111010111111111101110
011101111111111010111111111101110
011101111110011111110011111101110
011100111111111010111111111001110
011110000000000010000000000011110
011011111111111111111111111110110
011111111111111111111111111111110
011111111111111111111111111111110
000000000000000000000000000000000
