000000000000000000000000000000000
011111111111111111111111111111110
011111111111111111111111111111110
011111111111111111111111111111110
011110110111100000000000000001110
011110110111111111111111111101110
011110110111111111111111111101110
011110110111100000000000001101110
011110110111111111111111101101110
011110110111111111111111101101110
011110110111111111111111101101110
011110110111111111111111101101110
011110110111000010000111101101110
011110110111000010000111101101110
011110110111000010000111101101110
011110110111000111000111101101110
011110110111111101111111101101110
011110110111000111000111101101110
011110110111000010000111101101110
011110110111000010000111101101110
011110110111000010000111101101110
011110110111111111111111101101110
011110110111111111111111101101110
011110110111111111111111101101110
011110110000000000000011101101110
011110111111111111111111101101110
011110111111111111111111101101110
011110000000000000000011101101110
011111111111111111111111111111110
011111111111111111111111111111110
011111111111111111111111111111110
011111111111111111111111111111110
000000000000000000000000000000000
